, Compendic scripturae

Ao = Der ulte Orient
AtlAhh = Alttcsturhenthche Abhcndlungen
Aulsc = Alttestumentliohe Studien, Leipzig 1913
Bse “-.-.- Bibhsehe Studien
BW = une Biblicul World ’
ΒΖ -- Biblisehe Zeitsehrift
ΒΖΕῚ = Biblieche Zeitfrugen
BZSF = Biblische Zeit· und Streitfregcn
CH = Codex Hummurapi
CIS = Codex inscriptionum Semiticurum
ΕΒ = Encyclopeediu hiblicu
Enp = The Expositor
Exp'l' = The Expository Times
GJV4 = E. Schtirer, Geechiehte des judicchen Volkes im Zeitalter Jcsu' christe
Jssu = Journal of Biblicuh hitereturc
Jos. Α] = Antiquitcteu Judctcue
Jos. BJ Ξ Bellum Juduicunr
Joe, CAp = Contru Apionem,
Joc¹ Vit = vitu ’ν ¹ ¹ ¹
KATt = Ε. Schrader, Die Keilinschriftcn und dus alte Tectunrenta
KB = Keilinschrit'tlichc Bibliothck
Kth = Der Katholih
ΕΒ = M. Hagen, chicon biblicum
M = Mischnu Α
MuNDPV ὲ, Mitteilungen und Nochriehtcn dec deutschen Peltetinuvereins
MSG Ἴ = J. P. Mignc, Putrclog, Ser. Gracc.
Mun = ἆ, P. Migoe, Putrclog. Ser. hut.
Orhz = Orientalistischc Litcruturneitung
erse = Orientuhsche Studien, Cieesen 1906
PEF = Palestine Explorution runc, Quurterly Stutcrnent
II

 

